发布了头条文章：《达内教育遭多名消费者投诉“诱导学员贷款、虚假宣传”》 @国际教育曹红   达内教育遭多名消费者投诉“诱导学员贷款、虚假宣传”	消极
果然就我一个人会给踢皮球，派出所一会儿说去找教育局现在又是劳动局  我去劳动局看看会不会给踢到教育局	中性
丧心病狂的达内企业，请求各级政府领导部门关闭达内培训机构，还那些人公道，我不为自己，为朋友和家人一些忠告，出来就业要看企业资格证，如果没有，不要去了，我希望微博朋友给我点个赞！	积极
这就是达内科技教育培训！他们以为招聘面试骗你过去代高利贷，今天因为小孩子玩手机，在微信上小孩给他发了信息，它威胁我，我的资料信息在它那里，它骂人，它说要想办法找人报复我，弄死我，达内就是骗子公司这就是达内的嘴脸！现在已经落出尾巴了，！大家千万别去！以前在人才市场看见过，好几分公司，都去过，都是骗钱上课的，因为这个，我才去查出来骗代高利贷的事，#达内骗局# #达内骗子，不让人活##达内与易信骗子##论达内教育是怎样坑人的##达内教育#	消极
垃圾#达内骗局# #达内骗子，不让人活##达内与易信骗子##论达内教育是怎样坑人的##达内教育#	消极
"上班狗报道	中性
满嘴口腔溃疡但还是念念不忘火锅🍲	消极
想吃火锅了	消极
#火锅# 深圳"	中性
马上就学完了ui 要找工作了 好迷茫#ui# #设计培训#	中性
" 达内这骗子公司，以招聘为诱饵骗人来他们这培训（不管你做的有多好多NB他们都会说离我们的要求差远了之类的话）一开始我面试，人事给我讲了IT界多NB多厉害，其它职业就是垃圾，还说几个月后月薪能到5-7万一堆谎话，我当时答应了说可以参加复试。第二天早上我在坐车的时候查看一些关于达内公司的资料，让我很震惊的是这家公司负面新闻远大于正面的新闻而且和我是经历很类似。我准备去达内告诉人事说我不参加复试了，到了之后那人事又开始又给我讲了一大堆，我问是不是骗子公司呀？她说：我们一个上市公司骗你们刚毕业的学生干嘛？！（干嘛？！达内自己没点b数吗还干嘛。达内和一些贷款公司合作专骗哪些刚毕业的学生让他们贷款，以培训费为由连本带利要20000多而且毕业后连工作都不给安排）我当时有点想走了就说算了我还是走吧，当时面试官骂我你是不是有病，脑子是不是有病？！（一些难听的我就不在这举出来了）我强压着怒火说：都成年人有事说事。她依旧不依不饶的骂，我直接就摔门而出了。	消极
在此我想说达内不仅是骗子公司而且连员工素质也极差。我面试的地方是（云峰大厦7楼）想去的朋友要留意全是坑，我想对那个姓王的女人事说别以为你人事就NB就了不起，被人当枪使都不知道呢"	消极
1.这些年，在主流招聘网站上，确实看到  是常年招聘，有博友通过@青岛招聘资讯 曝光说它就是招生卖课程。难道它又“换马甲”了？求辟谣。2.曝光贴中的求职者，不应该先骂对方，否则不会招致恶毒反击。建设和谐社会，人人有责。	积极
#教师节#啊嘿，第一次收到教师节礼物！开心😌 😌 😌感谢  @健康养生老司机	积极
达达达达内杯，巅峰对决。  深圳·龙岗区	积极
#教师节#啊嘿，第一次收到教师节礼物！开心😌 😌 😌感谢  @健康养生老司机	积极
达达达达内杯，巅峰对决。  深圳·龙岗区	积极
参加#达內#培训，花了400买了网络营销的证书，今天面试，老板说没用，说现在培训机构都在坑学员钱，他们中家抽好多钱	积极
，#达内科技集团#，#达内培训#，#广西南宁市达内软件科技有限公司#骗子的成功就在于厚脸皮+技巧+坚持，看看达内这个上市公司又按老花样来骗人了。【软件开发实训生(理工科)：月薪：3000-5000元(试用期80%,三个月转正)】去到那里不叫你交钱才是怪。网页链接	积极
小心这些#就业陷阱#毕业生注意了！ 就是一个培训机构，打着招聘的幌子让你交钱！面试时先打击你，要求你上岗就必须培训，一期一万多。我一个室友就不幸中招。应聘时被洗脑，交了500元所谓可退的押金，时隔两周迟迟要不回。昨晚看到这些帖子，心都凉了。@新浪江苏 @南京头条 南京·三江学院南校区	中性
