【 公司：外编人员没有产假】近日，河南郑州许女士告诉@小莉帮忙 ，自己已经怀孕七个半月了，公司却要因为外编人员没有产假2次劝退自己，且不给自己安排工作。@小莉帮忙 记者了解情况，工作人员称：没有人知道她怀孕了。而随后经理说：怀孕来回跑不适合做销售。最后经过调解该公司表示：尊重女性，保护孕妇在工作期间正常应得的合法权益，也是公司和全社会应该做的。 #蓝V视界# 小莉帮忙的微博视频	积极
【扩散！这些孕期、产期、哺乳期的法律常识，你一定要知道】近日，近日，河南郑州许女士怀孕七个半月，却要因为外编人员没有产假2次被劝退。按照《妇女权益保护法》第27条规定，任何单位不得因怀孕产假哺乳等情形辞退女职工。关于孕期、产期、哺乳期的法律常识，你知道多少？转发收藏！	积极
" 最近风气太左了，按照苏联的理论，世界上有阶级而无民族，这段时间感觉我们的政策也是这种感觉。可能是全面脱贫是针对“阶级”来讲的，身份的事先放一边了。	积极
国家的政策思路是，我拿收上来的钱去修路 修网线，后面有能力赚钱的人去赚钱，这些基础建设全部算社会福利。而不是像欧美国家一样撒钱发高福利。可是这样思路永远福利的是有工作能力和能抓住工作机会的人，女性由于家庭已经天然的被排除在外了。	积极
我们之前是看民族的，这几年少数民族高考加分不也是被喷得厉害。怎么说呢，身份政治其实并不是完全错误的，竖切的这一块人如果在社会上拥有同样的困境，其凝聚力比单纯的阶级强的多，举个例子，全世界996人组成一个有共同记忆和集体意识的民族，那不是无敌了。福利还是要学的 不要不学啊，咱们国家她也不缺钱啊"	积极
"  大家记住，孕期、哺乳期无故辞退员工是违法的。劳动者如果不幸遇到这种情况可以协商，协商不成可以申请劳动仲裁。	消极
另外，再次强烈呼吁将男性陪产假延长至和女性产假时间相等！不说原因，懂的都懂。"	消极
真希望提出三胎的各位专家们多看看这种社会新闻。	积极
生个屁 资本家没妈	消极
少生优生幸福一生，不婚不育芳龄永继	积极
女性权益都没用保证，还要生孩子，还要多劳动力想多了吧。这样结婚生孩子没点保证谁生？	积极
"	消极
国家鼓励生育，企业辞退孕妇，在女性社会地位难以改变的现在，年轻人恐婚恐生的情绪是不可能有所改善的。"	积极
以后企业家们又想出一个高招，采用外派“模式，反正你是外派的管我何事	积极
"	消极
国家鼓励生育，企业辞退孕妇，在女性社会地位难以改变的现在，年轻人恐婚恐生的情绪是不可能有所改善的。"	积极
以后企业家们又想出一个高招，采用外派“模式，反正你是外派的管我何事	积极
【#女性的正当权益不应被侵犯# ！】女职工保护的法规↓为自己，也为身边的她，转发！	积极
女性太难了！三胎政策会导致女性就业越来越难，对女性社会保障不够	消极
太锤子了结屁婚生屁娃	消极
"	消极
哎，这样下去还有人想生孩子吗，连工作都保不住，怎么养孩子"	消极
如果我是一个私营企业主，一个岗位男的也能干女的也能干，来了两个求职者，一个是28岁的已婚男子，一个是28岁的已婚女子，背景能力工资要求看不出明显区别，你猜我招谁？	积极
以为生孩子只有生的时候才会痛？以为生孩子一天就能解决？其实从怀孕就开始各种身体不适，孕吐盆骨疼水肿便秘，生完孩子身体受损，做不好月子一身月子病，还要至少六个月的哺乳。这些都是资本家看不到的痛，也是没有经历的人无法体会的 上海	积极
这些就业问题不解决，一天到晚喊着三胎有用吗？也就公务员事业单位会没那么在意产假问题，其他企业也是从利益角度考虑，也不全是他们的错。归根结底还是需要国家从制度上出台一些保护怀孕女性和维护企业利益的政策。	积极
女性真的很难 这还鼓励三胎 就让女的什么也不干在家生孩子得了	消极
"	消极
谁还敢生孩子🥲"	消极
"	消极
	消极
国家提倡二胎，医院提倡母乳，专家不建议隔代带娃	积极
婚姻法要求女性经济独立，宝宝需要妈妈时刻陪伴	积极
老公要求老婆貌美如花，婆婆要求儿媳孝顺顾家有事业	积极
这样的社会压力谁还敢生 济南·鲁商盛景家园"	消极
这是我到目前为止看过的最让人😅的发言。	积极
休完产假上班一个月了 感觉力不从心	消极
"	消极
？？？？	消极
一边鼓励妇女多生，一边鼓励独立女性，职场女性，好家伙，一人劈成三个用呗"	积极
"	消极
？？？？21世纪了还有这么不正规的公司吗？五险一金不是白交的啊～"	中性
"【#氪星播报# | 9月26日晚间都有哪些#今日大事件#？】	中性
Top3大新闻	中性
1、#辽宁电力供应缺口增至严重级别#，将尽最大可能避免拉闸限电	积极
2、#一辆车绑定100多个手机号#，停车一小时仅需两毛钱	中性
3、自信女孩最美：#女大学生大方介绍父母收废品的#	消极
	消极
科技财经互联网热点	积极
1、#华为轮值董事长回应为何不造车#：“越是人人都造车的时候，越要冷静”	中性
2、#苹果确认部分iPhone13存在bug#，网友晒#iPhone13拍照有马赛克#	积极
3、破坏看视频需下载爱奇艺客户端限制，#爱奇艺起诉破解其会员公司获赔21万#	消极
	消极
还有哪些其他要闻	中性
1、#北京将禁止携带电动代步工具乘地铁#：电动代步工具易引起火灾	消极
2、#保洁捡走23万玉镯失主被迫用1万感谢金要回#，当事人：物业竟没有把她辞退	积极
3、#河南老人和学生可用纸质健康码#，没有智能手机也能用健康码	积极
4、#樊振东夺得全运会男单冠军#	积极
5、 ，公司：外编人员没有产假	消极
6、#中疾控专家认为厦门疫情已进入拖尾期#，感染源来自于集中隔离人员	积极
7、#女孩刮到男生车双方划拳私了#，网友：缘分就这样来了	消极
8、#超市老板娘为晚归女孩留灯10年# ：亮到凌晨2点，还会护送胆小女孩	中性
9、#我国成功从美国追索12件文物艺术品#，文物艺术品划拨西藏博物馆	积极
10、#民警用奶茶换下女孩手中菜刀#"	积极
开放三胎，就还蛮好笑的	积极
现在工作越来越难找了，没生育的担心你上班以后要生孩子，有孩子了要问你孩子多大了，防着你生二胎，女人真难 杭州·新街	消极
现在工作越来越难找了，没生育的担心你上班以后要生孩子，有孩子了要问你孩子多大了，防着你生二胎，女人真难 杭州·新街	消极
国家鼓励多生，公司希望别休产假，这就是如今的矛盾点	中性
魔幻但也现实	消极
笑死了 政策是要女人生三胎 对策是女人怀孕即辞退 妙啊	中性
真是好笑，不停地宣传二胎，宣传开放三胎，弄个离婚冷静期，却从没有在根本上去解决过问题。不知道是没体察过民情还是只需要数据表面上好看就可以	积极
要想真正的保护女性 对这种公司就应该有政策狠狠罚 罚的他们知道疼 疼的深入骨髓 就会老实	积极
事业单位都很多不愿意要女生更别提干活才给钱的企业了！那些说不干活还得白养你一年的你不仅是不识数不知道产假在北京只有128天，而且你不是妈生娘养的么？你妈生你时候就生那一天在医院么？你没有老婆孩子么？如果你是这样的人希望你以后千万别有老婆孩子！开放三胎政策是需要国家和企业一起努力的.但是当生存都是问题的时候 就不可避免的推动不下去这个政策 希望国家健全制度，产假延长到一年！男性职工交的生育保险好好都用在孕妈身上！	积极
"	消极
一天天说什么三胎政策 其他硬件根本没跟上结局最后还是女性买单 承担后果。	消极
国家还给给那些婆婆 七大姑八大姨催生保驾护航而且你告诉公司说你不生孩子 公司敢信吗？你就直接发文 女的全部回家生孩子 不就好了"	积极
这才是真实的世界，一胎都没人给你保障。	积极
#专家建议放开三胎##男子猥亵15岁干女儿被拘8天# 生呗	消极
尽管越来越多的女性权益逐步受到法律保护，但仍有女性正在遭受家庭暴力，在就业中遭遇性别歧视……妇女能顶半边天，了解合法权益↓	积极
不结婚保平安	积极
【财经早报 | #入职体检代检收费可达数万元#】更多资讯：十大券商一周策略，市场的第三股风正来临；#夫妻合伙诈骗亲友3200余万#； ；#辽宁电力供应缺口增至严重级别#；#官方通报江南布衣童装不当图案问题#；#俞敏洪回应近况#；更多>>网页链接	中性
不婚不育，屁事没有。 青岛·新兴小区	中性
公司没理由辞退怀孕员工。现在都签劳动合同的，本身就没有什么正式工和临时工的区别。扯临时工理由的，都是耍流氓。	中性
上班路上🤰 香港	积极
"	消极
然后还各种推崇三胎 你让谁生 让男的生去吧🤭"	积极
笑死这样谁还敢生孩子	消极
这还怎么生，谁还敢生	消极
产假好像剖宫产的最长 6个月产假 顺产好像短点	中性
希望以后的社会女人能更独立，婚姻自由，生育自由！不要越来越倒退！	积极
请曝光公司谢谢	积极
"	消极
我们单位简直太好了	积极
产检假也都正常给	积极
上班也挺轻松的	积极
就是天津的产假，护理假，婚假时间全国最短"	消极
闹成这样了，班还能继续上？留下了过不了多长时间公司也会找别的借口开除你，这就是结果。 还有网友说，辞退孕期员工违反劳动法，无论正式临时员工、孕期及哺乳期企业都不得辞退。也就是说临时工也一样享有法定的产假 闹成这样了才说尊重女性？早干嘛了？	积极
"从经济方面和想获得家人尊重方面考虑，很多孕妈怀孕虽辛苦，也坚持去上班。因为只有上班，才能保障收入，才能让家人看到自己的勤快、上进、不矫情。	积极
从健康方面考虑，很多女人怀孕后也会坚持继续上班。当然，出于这种目的上班的孕妈，最好做一些轻松的工作，适当活动，不要过于劳累。 "	积极
哎，还好决定不生孩子，把生孩子这个计划排除掉，人生轻松许多。	中性
什么时候法律可以真正起到保护作用？	积极
真心希望科技发达，男人也能生孩子！🙏🏻	积极
本来找工作就已经很难了，能不能不要再为难女性了，要女性生育繁衍，又要女性自立自强赚钱，还要学会控制情绪不矫情，这些都做到了。这个社会现实就是没有给女性足够安全感和保障，毕竟维权的成本大于所赚取得到的。	积极
【扩散！这些孕期、产期、哺乳期的法律常识，你一定要知道】近日，近日，河南郑州许女士怀孕七个半月，却要因为外编人员没有产假2次被劝退。按照《妇女权益保护法》第27条规定，任何单位不得因怀孕产假哺乳等情形辞退女职工。关于孕期、产期、哺乳期的法律常识，你知道多少？转发收藏！	积极
本来找工作就已经很难了，能不能不要再为难女性了，要女性生育繁衍，又要女性自立自强赚钱，还要学会控制情绪不矫情，这些都做到了。这个社会现实就是没有给女性足够安全感和保障，毕竟维权的成本大于所赚取得到的。	积极
【扩散！这些孕期、产期、哺乳期的法律常识，你一定要知道】近日，近日，河南郑州许女士怀孕七个半月，却要因为外编人员没有产假2次被劝退。按照《妇女权益保护法》第27条规定，任何单位不得因怀孕产假哺乳等情形辞退女职工。关于孕期、产期、哺乳期的法律常识，你知道多少？转发收藏！	积极
真就是现实，好在生在网络时代，有媒体当做新闻材料！不然还没人理	积极
这是我到目前为止看过的最让人😅的发言。	积极
近日，河南郑州 公司却要因为外编人员没有产假2次劝退自己，且不给自己安排工作。	消极
这么恶心的事反正我是干不出来，不知道这人事是不是女的 怎么说得出这种话真是公司的一条好🐶	消极
看的生气， 做女人真难。	消极
"	消极
	消极
看到有人说，一边鼓励女性生三孩，一边又辞退怀孕女员工，职场女性太难。	消极
	消极
其实，这完全是两码事：鼓励生育的是国家，辞退怀孕女员工的是企业。不是企业跟国家唱反调，而是企业的利益没有得到保障，资本又是逐利的，他们肯定会选择牺牲劳动者的利益，来保障自身的利益。	积极
	消极
这也是这次国家放开三孩政策时，提到要完善一系列配套制度的原因。要女性多生孩子，那就需要保护她们的合法权益，尤其在职场中，劳动法如何贯彻，相关社会保险如何落实，不只是国家一句“休假”“放假就可以了的，而要综合考虑保障女职工生育保险和保障的同时，平衡企业等相关方利益，才能让这孩子生得安心。	积极
	消极
#V光计划#"	中性
还是人太多了，像北欧一些国家一共就那么点人，还容得你挑来挑去的，有人干活就不错了。总是说没人生孩子国家要完蛋了，别的国家几千万人不也照样过，美丽国四亿多人也不耽误人家成为超级大国啊，吃人口红利本来就不是长久之计，少生优生，幸福一生，这句话是真的	积极
"以前公司有位女员工，怀孕了。	积极
	消极
她刚入职就怀孕，担心工作没了，就没敢跟直线经理讲。	积极
直到三个月才告诉了经理。	积极
经理却觉得她有心机，孕期一直没给她好脸色。	积极
产假结束后，她重回工作岗位。	消极
经理给了她一个无论怎么都不可能完成的指标，摆明了就是逼她离开。	积极
最后，她辞职了，走的时候和经理大闹了一场。	消极
	消极
几年后，她辗转了几家公司，换了几份工作。	消极
孩子在长大，她工作也越来越出色。	积极
终于，她也做到了地区经理的位置。	中性
	消极
有一天，她和我聊天，跟我说：组里有两个女员工怀孕了，好烦啊！总觉得她们没有干活。	中性
我说：你现在是不是能体会到当初xx得知你怀孕时候的心情了？	积极
她叹了一口气：哎，每个岗位都有每个岗位的难。	消极
	消极
很多大公司的规章制度看上去是保护孕妇的。	积极
但确实很多时候，孕妇在职场是备受歧视的。	积极
因为直接决定孕妇命运的，是她的顶头上司。	积极
	消极
特别是销售领域，怀孕就意味着无数次的产检，会耽误工作。产后四个月的时间，市场处于空白区域，新人无法及时上手，老人可能也不愿意去接手一个可能随时会还回去的市场。	积极
这时候团队业绩就会受影响，会直接影响到团队leader的业绩。	积极
	消极
所以，孕妇，特别是做销售的，在职场遭受不公平的待遇就成了常态。	中性
	消极
我做销售的时候认识的很多女性，产假一两个月就回去上班了。	中性
没人逼她。	消极
但不回去，位置就是别人的了。	消极
	消极
这就是现实。	中性
"	消极
以后怀孕了发生只这事情女性只能留联系媒体吗	消极
这公司完球子了	中性
先解决女性的生存问题再说三胎的事儿吧，怀孕丢了饭碗拿什么来生孩子养孩子？！教育医疗到处都要花钱…普通家庭三胎加生育失去工作女人。靠男人一人扛不过来吧	积极
别说了，公司为了响应国家三胎政策，鼓励大家生三胎！但是不能怀孕！	积极
这个公司的哪个人不是女性辛辛苦苦怀孕生下来的？	消极
公司你完了，现在国家提倡三胎，感觉你在和我国决策作对	积极
能劝退就好了，我们这夜班上到七个月呢	积极
我一直觉得三十岁的我已经完成了二胎，并且孩子们都独立去幼儿园了。算是我职场里的一大优势，没想到的是，单位还是在招聘的时候对男性同志很偏爱，对男性求职者有更大的期望。可见职场对女性的不公平。挺难的  烟台	积极
虽然有法律保护，但是很多用人单位还是会对女性员工怀孕做出相应“手段”。加之女性员工生孩子坐月子休产假回到原来的刚回，刚开始会不适应，也会发现公司找个一个年轻能干的顶替了	积极
国家提倡二胎，医院提倡母乳，专家不建议隔代带娃 婚姻法要求女性经济独立，宝宝需要妈妈时刻陪伴 老公要求老婆貌美如花，婆婆要求儿媳孝顺顾家有事业 你前面说的我都同意。但我不敢说你最后说的这句话，因为这样就会被攻击为挑起性别对立，是女拳了。	积极
" #知识分享大会# 【地道表达250】	积极
哪个是“产假”的地道表达？	消极
选完看评论区答案 网页链接"	消极
好烦，为什么这种问题只有舆论起来时候才能得到解决，公司能不能有点ac数，很多人可能没有精力去维权就吃了哑巴亏	积极
"	消极
有些领导自己也是女人，女人何苦为难女人，	消极
能保证以后你生的一定是儿子，你儿子生的一定是儿子？"	积极
郑州的垃圾公司太多太多 交社保的都没几个	消极
都是没学过劳动法的，也不怕被请去赔钱。	消极
热搜怎么全是小莉帮忙？	积极
职场孕妈，这些权利一定要了解！女性的正当权益不应被侵犯！在职场，孕妈受哪些法律保护？享有哪些权利？看图了解↓↓	积极
我们这行基本是上班上到生，除了到了一定月份不上夜班，其他都照常，所以不存在被劝退的现象	积极
呵呵，我找工作的时候直接被告知你各项都符合，但是在适合婚育的年龄，我们不想给婚假和产假，所以人事不批	消极
这都成普遍现象了，就这，还鼓励生二胎开放第三胎，谁tm敢生，一胎都生的瑟瑟发抖好吗！	消极
都是没学过劳动法的，也不怕被请去赔钱。	消极
热搜怎么全是小莉帮忙？	积极
职场孕妈，这些权利一定要了解！女性的正当权益不应被侵犯！在职场，孕妈受哪些法律保护？享有哪些权利？看图了解↓↓	积极
我们这行基本是上班上到生，除了到了一定月份不上夜班，其他都照常，所以不存在被劝退的现象	积极
呵呵，我找工作的时候直接被告知你各项都符合，但是在适合婚育的年龄，我们不想给婚假和产假，所以人事不批	消极
这都成普遍现象了，就这，还鼓励生二胎开放第三胎，谁tm敢生，一胎都生的瑟瑟发抖好吗！	消极
现在大多数公司都是这样，你给他带来利益时候老板脸笑的是给你一顿夸，你稍微给公司带来不好就开始各种理由推脱， 之前公司上班女的就要检查就怕你是怀孕进的公司怕占便宜，，，感觉这样特不舒服，没有女人何来下一代，需要呵护 。	积极
【#辞退孕期员工违法#！】	消极
生育率迟早超过han国看谁负的多	消极
三胎福报，在一个低福利国家，什么都不想付出还拼命催生	消极
看看这就是现状啊	消极
为啥现在的年轻人一胎都不想生 没点逼数？还tm积极响应国家的号召呢！家里条件好的孕妇好像也没必要挺着肚子上班为的是减轻经济负担吧！真是无语了 政策是响应三胎 对策是辞退孕妇？要不然你就把所有女的都辞退 不生完三胎不允许上班 把男的都累死得了！整的啥破事儿啊 东营	积极
这不是发了么，恭喜这位女士，这种一告一个准	积极
"	消极
不生孩子，屁事没有"	消极
"	消极
肛生子	消极
肛生子	消极
肛生子	消极
我说累了"	消极
不婚不育，屁事没有。 青岛·新兴小区	中性
所以谁爱生谁生咯，我又不傻	消极
不结婚保平安	积极
孕期 无论正式或临时员工在孕期及哺乳期，企业都不能辞退，辞退孕期员工触犯劳动法。	积极
公司这种做法就有点太不厚道了吧 这样下去谁还敢生孩子啊真的是奇葩年年有 这种做法只会让越来越多人不敢结婚生孩子了	积极
" 不要小看女性。 作为一个企业，要相信女性的力量，维护女性正当权利。	积极
产假那几天算什么？劝退就有点弱智了，女性归来只会产生比你想象得更大的效益。"	消极
#普法课堂# 【这些孕产期的法律常识，一定要知道】  引关注。关于孕期、产期、哺乳期的法律常识，你知道多少？戳图了解下↓↓转给你关心的她！	积极
"	消极
女人永远不要结婚不要生孩子，儿孙自有儿孙福，没有儿孙我享福"	消极
还生啥三胎，一胎都别生了。姐妹们快逃啊[开学季]	消极
要不现在女性没办法结婚。我认识的要么独立自强自己买房买车高工资，在北京大城市努力打拼，30多奔四十找不到结婚的。要么就是结婚了带孩子，因为生孩子耽误了个人发展，带孩子也不愿意出门了，养孩子花销大，给自己也不买衣服化妆品了。现在又想有家庭又想有好工作，还要三胎，这怎么完成啊	积极
太难了吧真的。。。难道怀孕的女人就只配做家庭主妇了么?想不明白	中性
还三胎政策了，这谁敢生，让男人来生吧	消极
劳动法真的藐视，就这还三胎…… 除非家里有矿	消极
"	消极
把女的都搞回家生孩子，二胎三胎四胎五胎，然后出轨再找再甩"	消极
想当年，就因为我怀孕，我们整个部门的工资一直涨不上去，这也是我后来才知道的原因。六个月，我直接辞职！辞职的时候，大领导恶心地说，没想让你辞职！我那边刚走，我们不能留涨工资了。当时觉得自己特别对不起他们，害得他们少领了六个的钱！一般企业对孕妇都有成见	消极
"	消极
还鼓励生三胎！啧啧啧"	消极
"	消极
嘻嘻还三胎呢....就这 谁敢生啊？	消极
就这社会环境 开放三十胎都没人敢生呐"	中性
这就是开放三胎的态度？哦我忘了，他们的目的是把女的都敢回家生孩子。	中性
好的，请大家多生三胎	消极
"	消极
哪个人不是妈妈十月怀胎，辛苦养大的呢？企业要发展，社会催着赶着让企业不断提高效率，最后女性怀孕带来的种种只有自己买单，根本解决不了问题，国家还要要多出政策，给企业减负，给年轻人减负，给女性多一点的保障。又想让女人独自自强，承担家庭责任，为社会贡献，又想让女人照顾家庭，青壮年时期多生育，怀孕生产休产假哺乳假，两年也就过去了，升职加薪基本也就无望了，养育孩子既需要钱也需要时间，又去指望谁呢，太多困难无解了……"	积极
，池.啊XC，A ZZ	消极
"	消极
一边说着女性要独立自主，一边又鼓励妇女多生孩子，结果资本主义们就是这样过河拆桥，哈哈哈哈哈哈哈哈，是想笑死谁啊？？？？"	积极
[苦涩]感觉这样的企业有很多，我身边就有这样的人，怀孕了领导知道后各种看着人家不爽，想各种办法让人家干不下去｢(ﾟﾍﾟ)	消极
"  女人怀胎十月拼命生下来的孩子默认随男姓，由于生孩子带来身体损伤和职场损失全都由女性承担。天下还有比这更不公平的事吗？	中性
只要男人一天不承担生育带来的负面影响，职场女性歧视就永远无法得到解决。	消极
强制要求男性休女性同样时长的产假育儿假，与女性错峰休假，承担照顾孩子的责任，才能彻底改善职场性别歧视。"	积极
就这，天天还催人多生，还开放三胎，谁敢生啊没了工作自己没有收入以后在家没有地位，花钱看别人脸色，这也是天天热搜爆的，还是算了吧，可别生孩子，好好搞事业。	积极
比较少见。	消极
对女性恶意真大	消极
"	消极
我只想说，姐妹们…钱和事业最重要…专心搞事业吧"	积极
真就是现实，好在生在网络时代，有媒体当做新闻材料！不然还没人理	积极
【#辞退孕期员工违法#！	消极
"	消极
开放了三胎政策，被催生三胎，然后怀孕了还得被劝退，，，连产假都没，，"	消极
法律对女性职工孕期的保护	积极
"	消极
	消极
今天刚去领证，最多生一个。谁劝都没用，问就是优生优育。	中性
新上任老公听话任劳任怨，公婆年轻明事理。	积极
虽然双方家庭不富裕，但是总会越来越好。	积极
	消极
现在女性真难，鼓励生三胎，公司也有自己的难处，工作就业难。	消极
你不工作专职带娃。说你脱离社会跟老公没有共同语言，你老公出轨你活该。	消极
你努力工作，说你不关心家庭，孩子叛逆不听话都怪你对孩子不够关心。	消极
等等，总归是你的错"	消极
" 去法院告它，让它吃不了兜着走呗。	消极
	消极
一百块钱，一分为二，这感情真好。	积极
共患难是真的，有福同享也是真的。	消极
	消极
…	消极
我是是是若人先生 贵阳·宅吉"	中性
" 去法院告它，让它吃不了兜着走呗。	消极
	消极
一百块钱，一分为二，这感情真好。	积极
共患难是真的，有福同享也是真的。	消极
	消极
…	消极
我是是是若人先生 贵阳·宅吉"	中性
"	消极
怀孕意味着失业，企业一般不会开除你，而是逼你主动辞职 (事业单位除外)"	消极
这样的企业应该还多着呢	积极
"	消极
老板要是无良起来，简直都不能称之为人，偏偏这种老板还很多"	积极
公司应该正常为员工缴纳生育险吧？具体情况不太了解，但是，在女职工怀孕七个月时劝退，那是妥妥的违法了。现在很多企业求存也很不容易，作为怀孕的女职工就更难了，但现在这个结似乎很难解开。	积极
一边提倡三胎！一边说保障女性职工生育权利！一边说开放女性和男性的产假，这才是三胎政策的的开始呢！换来的是什么？这样的事情在社会上还有多少？？果然不婚不育最幸福	积极
"	消极
离大谱。"	消极
"	消极
我同事之前被分配到乡下当老师 也是因为🤰被辞了 真就离谱"	积极
这都是因为现在企业老板越来越黑心	消极
"	消极
就无语…一边鼓励女性多生，一边又这样吃人血馒头。。闹成这样了才说尊重女性？早干嘛了"	消极
每天一个恐婚恐孕小技巧 给准妈妈的基础保障都做不到谁还敢生三胎啊[哆啦A夢害怕]	消极
呵呵呵呵呵，鼓励生育却不给保障，呕了	中性
"  这种企业的做法真的挺不地道的，孕妇必要时刻一定要用法律的武器保护自己。	积极
但是现在说实话，我自己也是开公司的，公司老板又要考虑的也不一样。考虑效率，人工成本等等。	中性
所以从中间的身份讲，企业换位思考，员工不要因为怀孕而误工，多多理解吧。	积极
在家里，没有固定收入便会被嫌弃，时间长了这些所谓的全职太太自然就会被冷嘲热讽。所以女孩子最好能有个副业，任何时候可以掌握话语权。	积极
这是我的一点点🤏小建议。强大自己就是解决问题的核心。———— 一个备孕中的创业者 广州"	积极
"	消极
一边边鼓吹女性生三胎	消极
一边却不能保障好女性的权益 有效遏制职场歧视的蔓延	积极
反而让企业那边觉得孕妇麻烦 孕假期间不能给公司创造效益还得让他们支付工资 结果就是在面试时加重性别歧视	消极
资本家确实可恶 但是跟他们谈条件得讲究章法呀	积极
不然谁敢去响应你这三胎政策"	中性
"	消极
如果是劳务派遣的情况，用工单位也要依法提供劳动保护的。三期女职工不可以随意解雇的，而且用人单位也还要履行对该劳动者的保护义务。	积极
劳务派遣用工的现象很多，人家不是什么所谓的大众口中的临时工，他们跟签订劳务合同的那种人员还是有区别的，粗到他们的公司，细到他们的权利义务。别整天指望着以临时工为借口就侵犯他人的合法权益。"	积极
此行为违法！按照《妇女权益保护法》第27条规定，任何单位不得因怀孕产假哺乳等情形辞退女职工；健识局问问大家，你们的入职体检会检查或变相检查怀孕情况吗？ 网页链接	积极
"  生育对于女性的代价，不仅仅是肉体上的痛苦，她们的事业和未来也被摆在了最岌岌可危的地带。	消极
	消极
我们曾和几位全职带娃后重返职场的女性聊了聊，她们比普通人更为谨慎而坚硬地拼搏着。	积极
	消极
职场普遍盛行的歧视，让她们普遍失去了更好的工作机会和收入；	积极
	消极
传统思想中对于女性顾家的要求，加剧了职场女性们兼顾事业和家庭的艰辛；	积极
	消极
而想要证明自己、担心拖累他人的压力，成为了焦虑的源泉。"	消极
那三胎就算了吧 这公司没人管的吗 起码先保证妇女工作吧	中性
就这还三胎，三你妈个比	消极
"	消极
我今年才24岁，在面试时几乎每家公司都会问什么时候结婚什么时候要孩子了	中性
还有前同事因为怀孕，部门整体加薪的时候就没带她。	积极
可能就是因为类似原因女性越来越不愿意生孩子吧"	消极
就这样还开放三胎？？？先保证妇女的基本权益吧！！！	积极
【必知！关于工资、休假、加班、补贴相关法律规定！】 女性保障，节假日等，事关你的权益！	积极
支持男女轮流各休三个月产假，既然决定生养孩子，双方就都得履行责任和义务并且承担就业风险。	积极
"  这种事情一看就是在郑州，郑州企业太丢人了 。	消极
人多工资少，各种恶心事情。	消极
我都觉得丢人	消极
无语，只怕全国只有河南工资低事多吧，哈哈哈 郑州·CBD商务区"	消极
" 漂亮了快乐地方任务从小到大责任人天天天天让人	积极
wq他也伊伊"	消极
"	消极
无语住了，真的非常无语。	中性
很小的事情就可以看出来，我们学校男生宿舍条件比女生宿舍好，快递站也在男生宿舍旁边。"	消极
想换个宿舍（读博了还倒霉催的住在四人间，爬梯），辅导员说，不能因为你怀孕了就对学校提要求，是你自己不愿意休学的，潜台词“自己受着吧”。俺就装作不晓得那份不休学声明没有法律效力吧	消极
那这还怎么生三胎？	消极
"	消极
所以二胎三胎不是那么容易想生就生的吧"	中性
"	消极
不生孩子 b事没有"	消极
我能说活该吗有些女人上班没几天就怀孕生孩子去了，她拍拍屁股跑去生娃，薪资保险都甩给公司负担，你知道某些小企业才赚几个钱？每招一个人都是成本ok？被开除了就闹事，这样直接导致以后的老板越来越不愿意招女生……爱生娃你专门回家生啊多生几个当英雄母亲大家还给你点赞，别祸害同事和老板了好吗？	积极
说白了，还得出政策，怀孕员工的工资等费用成本这一块可以抵扣shui之类的，才行，但是同时也要避免那些钻空子的toushui漏shui的。	中性
这下好了 大家都不想生了	消极
这公司是顶风作案？	中性
建议像鼓励应届毕业生就业一样。增加女员工比例可以免税。 否则，感觉政策力度一般。 济南·玫瑰花园	积极
"	消极
这没人管吗？？又让人多生，又让人没工作，这可咋整……"	中性
生三胎的，要么有钱，要么勇士。	积极
这个公司不执行、不遵守国家法律，是要准备独立么？	积极
"	消极
不仅仅是怀孕不怀孕的问题……因为有的会假定你3-5年内要怀孕所以直接不雇佣"	中性
一个被单位辞退者的自述，满满的无奈与无助 #幽默学园招新季#  涩大师s的微博视频	消极
"	消极
不仅仅是怀孕不怀孕的问题……因为有的会假定你3-5年内要怀孕所以直接不雇佣"	中性
一个被单位辞退者的自述，满满的无奈与无助 #幽默学园招新季#  涩大师s的微博视频	消极
"	消极
	消极
如果想要真正落实三胎政策，女性工作首先得有保障吧。。。如果这样，谁还敢生孩子哇"	积极
【9图了解女职工权益，还有多少病态的“怀孕审批”？】近日，河南郑州许女士告诉称自己已经怀孕七个半月了，公司却要因为外编人员没有产假2次劝退自己，且不给自己安排工作。无论何时何事，女性为社会做的付出，不该换来机会的不均。任何单位不得因女职工结婚、生育降低工资，予以辞退…9图了解女职工权益↓↓为她转发！	消极
生。是为了响应国家号召，不管什么单位辞退什么人，这就是与国家政策唱反调我emo了，看了多数评论，100个人参与，就有99个人说普遍现象的，所以该怎么办	消极
"	消极
就这	消极
还鼓励生三胎	消极
生一胎就会丢了工作"	消极
"	消极
职场女性的空间，将越来越狭小，代价也越来越大，就挺绝望的"	消极
"【#氪星播报# | 9月26日午间都有哪些#今日大事件#？】	中性
Top3大新闻	中性
1、 ，公司：外编人员没有产假	消极
2、#乡村教师失去左手坚守讲台15年#：我喜欢跟孩子们在一起	积极
3、#16岁初中女生获全运会霹雳舞冠军#，将备战2024年巴黎奥运会	积极
	消极
科技财经互联网热点	积极
1、#三峡集团总部迁回武汉#，带来超5500亿元“大礼包”	消极
2、#沈阳中介不得用学区房名义挂牌二手房#，不得抬高报价	积极
3、#上海价格虚高学区房挤掉300万水分#，投资客淡出	消极
4、据网友反映，#iPhone13拍照有马赛克#	消极
	消极
还有哪些其他要闻	中性
1、#儿子被卡洗衣机妈妈先拍视频#，发现拉不出来才打119	消极
2、#樊振东第三次晋级全运会男单决赛#，今晚将冲击男单的冠军	中性
3、#12岁女孩误食烧碱一个月瘦20斤#，目前正在接受后续修复治疗	消极
4、#南宁新增感染者隔离期满两次核酸阴性#	消极
5、奇奇怪怪知识增加了，#丹顶鹤的丹顶是由脱发造成#	消极
6、#民警追哭瘾君子后凡尔赛式发言# ：故意跑慢点，慢慢耗他体力	中性
7、#1米8女孩隆鼻后鼻孔歪了#：别人一抬头就看见	中性
8、广东发布节电倡议书：#广东倡议3层办公楼以下停用电梯#	积极
9、#王曼昱车晓曦进全运女双决赛#"	积极
@你好吗北北：我公司就是 因为最近怀孕的多，部门新来的姑娘马上就要过适应期了，结果被劝退了！原因竟然是，因为她是女生，怕怀孕！！！前提人家连男朋友都没有呢，就被这样…关键这样的企业应该非常非常多吧？？就这样国家还提倡生三胎？这样的大环境女人哪敢生孩子？哎… 北京·北店嘉园	积极
就这，还想让人生三胎呢？	消极
我之前工作的一家公司，周末两天要排班值班，只能调休不算加班，国庆7不给放假，工资就是平时的工资，没有按国家规定给三倍，如果国庆期间休假要扣掉当天工资的70%，见过不要脸的，没见过这么不要脸的！	积极
就这还开放3胎？生了谁养？	消极
昨天还跟室友讨论说现在现在同龄女孩子当中想要结婚生孩子的应该不是很多，可不就是这么个理儿吗。读了那么多年学好不容易考了个好大学，找了份不错的工作，就因为生孩子就给毁了，凭什么？女性努力的终点不是为了结婚生孩子，谢谢	积极
"	消极
遇到过前前公司的一个小领导（女）跟另一个怀孕的组员说你要么去打掉，要么离职。就这，还要鼓励家庭生二胎，生三胎，生你奶奶个腿"	积极
单位最近要招人，听主管意思明确只要男的，但是又不能都限制性别，最终方案招四个，其中三个岗位限制男性，最后一个岗位不限女人何苦为难女人	积极
【为女性就业权益转发】  引关注。未婚女性不招、生育一孩女性不招…遇到这些情况该怎么办？女性为社会做的付出，不该换来机会的不均。不得因女职工怀孕、生育、哺乳降低工资、予以辞退…更多女性就业权益↓↓转！（人民日报） #普法课堂##职场#	积极
"	消极
还提倡三胎呢	积极
怀都不敢怀啊这…"	中性
不给产假的企业跟要生三胎的专家打一架吧	消极
希望国家能重视这一块，我也是休产假期间各种劝退的。 宝鸡	积极
这样的公司就该狠狠的严惩，就因为是编外体制，就损害了怀孕女职工的合法权益。无论编内还是编外，职工还不是一样做事。相反，现实中编外的反而为单位出更多的力，而编内的似乎高高在上，动都不爱动。 福州·福清市阳下镇文化技术学校	积极
所以结婚生孩子的女生越来越少了，谈恋爱可以，结婚就算了，生孩子更是大可不必	积极
"	消极
三胎就留给有钱的人去生吧	中性
普通老百姓生不起"	消极
没啥用的，这个社会对于女性工作就是充满恶意，我们新园长在今年4月份就说了，你怀孕了就自行辞职，我们没有产假，等你生完孩子了，如果我们园有空缺你再来的话我们优先考虑。这话是一位公立园园长说的。	积极
" 乌鸡鲅鱼	消极
每日恐婚小技巧 沈阳·五里河公园"	积极
幸好有“小莉帮忙”，帮助很多人解决了不公平待遇问题，要不只能吃哑巴亏了。给小莉点赞	积极
国家正在努力鼓励女性生孩子，看看社会大众是怎么干的！难怪女人不喜欢生孩子，还真是不能生，一生就丢工作，就得让男人养，男人就会因为养女人发脾气然后出轨。这个世界还真是对女人不友好。不结婚啥事没有。💩💩💩	积极
怀孕七个月劝退，一个人的事，热度居然压过了东北的确限电，果然网络都是南方的 北京·西北旺	积极
国家难道不出手？应该严厉打击，这也是给妇女愿意生孩子的一个慰藉 肥城市	消极
还是要给男性等长的陪产假才行啊	消极
就这样国家提倡生育，不生最好，能不能对孕妇好点，不生了	积极
就这样国家提倡生育，不生最好，能不能对孕妇好点，不生了	积极
"	消极
就无语国家都大力提倡生娃，还有公司顶风作案，也是大胆"	中性
"	消极
我公司，从今年年初开始，在隔壁部门，陆续有休产假的，起步三个月，老板很贴心在楼下贴了告示：内有孕妇，请勿抽烟 广州"	消极
"	消极
	消极
那这三胎还好有人要嘛	中性
本来就挺排斥的 很多人不想要	消极
而且压力那么多	消极
现在这样更没人敢了"	中性
这种趋势发展下去，女nxl大胜利，直接面试出柜	积极
现在这些企业还在公然违法。	中性
河南郑州：女子怀孕七个月，公司为此要把她开除。 邢台身边事的微博视频	中性
就这？绝了 社会什么时候才能消除对女性的偏见 如果未来所有的企业或者公司 都是这种潜规则 没有一个女性会选择生孩子 连自己的工作都不能够有把握 你怎么能确定能给孩子一个好的生活！	积极
女人也太难了，既要工作，又要生孩子，还要照顾家庭	消极
怀孕七个月 be seven months pregnant；产假 maternity leave；男性陪产假 paternity leave；劝退 ask sb to resign；销售人员 a salesperson, a sales representative；有资格获得... be entitled to sth	消极
作为女人太惨了吧！	消极
一边3胎 一边职场歧视，这是要恢复男权社会？让女性寸步难行？ 女性的觉醒就是独立，过于独立，跟社会主旋律又不符了？？？	积极
就这样国家还想提高生育率？就这样还想让人生孩子，全部丁克，全部996得了，明年生育率继续跌	中性
又一阴间新闻	消极
"	消极
？？？就这还开放二胎三胎的，连自己的合法权益都保护不了了"	积极
还生三胎呢 还生吗 看看 连工作都生没了啧啧	消极
"女子怀孕七个月被公司称没产假劝退。。。	消极
	消极
#出道吧新星#"	积极
保障女性那些法律，就好像狗屁一样 你看看有几个公司怕啊才不管你怀孕呢 就辞退就辞退，公司的利益要紧 因为走法律程序麻烦啊 孕妇啊不得好好养着吗 再给你折腾流产了哦 才不怕你孕妇呢 回家多生几个孩子去吧	消极
所以坚决不生二胎三胎，女性就得这样被歧视吗，还是是女方一个人的吗，要这样歧视人的公司最好自己也回炉重造，这样他母亲也不会被歧视了	积极
"	消极
	消极
一边鼓励生育，一边却来个职场歧视女性，打压女性的生存空间，职场就从来没有对女性尊重过"	中性
"	消极
	消极
一边鼓励生育，一边却来个职场歧视女性，打压女性的生存空间，职场就从来没有对女性尊重过"	中性
跟生三胎政策放一起真的是讽刺至极	消极
说什么都没用，给男的加上陪产假。就就能解决所有问题。但是，上面是不会答应的。 重庆	消极
想起来入职那个月，主管部门和人力跟我讲出勤够天数就有全勤，后来只休息两天去了23天，结果到算工资时跟我说因为是节假日后新入职的，首月都没有全勤，而且是必须算作出勤少一天 ，倒扣一天工资	积极
"孕妇如果在怀孕期间继续上班的话，反而可以帮助自己的丈夫缓解经济压力，而且一个女性如果经济独立的话，在家庭中说话也是非常有底气的，所以这也就是为什么很多女性在怀孕过后仍旧选择坚持上班的原因。	积极
其实大多数孕妇如果身体不存在虚弱或者是孩子不存在危险的情况之下，都可以继续上班，毕竟上班对于孕妇来说也存在着许多好处。但是同时也更应该要注意休息，任何时候都不要强迫自己，这样才能保证自己和孩子的安全。 "	积极
别说女性的权益了，现在劳动者的权益都没给你保障好呢。上招聘app随便一搜，五险一金写出来的才是有得，没写就是没有。	积极
真是讽刺，生个屁三胎	消极
"	消极
就这，还鼓励三胎呢，一胎人家都不要你"	消极
麻烦赶紧让男的可以生吧，也不用麻烦我们了	消极
为什么要逼着辞退孕妇？要知道，辞退孕期的员工是违反劳动法！无论正式临时员工、孕期及哺乳期企业都不得辞退，临时工也一样享有法定的产假。倒是站公司角度，如果入职就怀孕，生完就离职的新闻也有，当然这个问题要另当别论……	积极
太他妈过份了！什么公司，帝国主义的公司嘛？	消极
每个能兼顾工作和家庭的女人都不容易。她并非超人，却有着超人般的意志和决心，把工作上的挑战当作一种历练，把家庭里的忙碌当作一种享受，把生活中的难题当作一种馈赠。	积极
"	消极
	消极
笑得 就这态度哪位普通职场女性想生三胎啊 就连最基本的工作都保不住 各种借口劝退还说没人知道她怀孕 拜托 7个多月大的肚子你当所有人都眼瞎的啊"	消极
国家要人生育总得保住人家饭碗吧，连饭都没得吃了还要个屁孩子，那是孩子吗，那是累赘	消极
我就是女权biao so？ 不女权有什么权益呢？	中性
谁都不怪，人家公司疫情暴雨，容易不，没倒闭都是命大了，姑娘又要工作又要生孩子，将来还要养孩子，容易不。 郑州	消极
"	消极
没有人知道她怀孕了？全公司都是瞎子吗"	积极
接下来就是为了避免这种劳动纠纷，公司决定不要女性员工	消极
"	消极
反正我二十来岁的年纪	消极
被面试的话问的最多的问题就是什么时候结婚？什么时候要孩子…	消极
cnm的公司都是一样的	中性
女性永远得不到应有的尊重和公平"	积极
"	消极
反正我二十来岁的年纪	消极
被面试的话问的最多的问题就是什么时候结婚？什么时候要孩子…	消极
cnm的公司都是一样的	中性
女性永远得不到应有的尊重和公平"	积极
这个公司的HR要么就是不专业，要么就是形势所迫，知法犯法了	消极
哈哈哈，第一反应就是这还提倡三胎，谁爱生谁生去吧。	积极
真是好笑，不停地宣传二胎，宣传开放三胎，弄个离婚冷静期，却从没有在根本上去解决过问题。不知道是没体察过民情还是只需要数据表面上好看就可以	积极
一边鼓励女性生三胎，一边又鼓励女性经济独立，又当又立。	积极
"	消极
我们没给你安排工作，就让你坐着就行～	积极
啧啧啧，	消极
这不就是打入冷宫吗？	消极
曲线策略用得也是够拙劣的"	消极
"	消极
一般现在就是富的生 或者越穷的越喜欢生	中性
大部分在温饱线徘徊的我们根本没考虑过要孩子"	中性
nan	消极
有些男的真的有那大病无比庆幸我的家人都是正常人	积极
独立女性人设是08年某女作家开始出书，之后各个综艺，平台，yzh，开始大谈独立女性人设，曾经的papi是个代表，可惜她结婚后被女拳骂了几年，所以国家可没有支持独立女性或者独立男性。望周知	积极
"	消极
一般现在就是富的生 或者越穷的越喜欢生	中性
大部分在温饱线徘徊的我们根本没考虑过要孩子"	中性
" 近年来，企业和女员工之间，似乎形成了一种十分微妙的关系，尤其是等到女员工处于怀孕的状态时，不少女员工就会遇到一些不太公平的待遇。	积极
	消极
尽管有相关法律对婚育的职场女性进行保护，但用人单位又不得不考虑最现实的用人成本，所以如今的女性在职场上依旧面临着不少的隐性性别歧视。	积极
	消极
不少女性网友直呼，职场对怀孕女性太不友善。也有不少女网友表示，为了避免这样的职场歧视，会考虑不生或者少生孩子。"	积极
有些男的真的有那大病无比庆幸我的家人都是正常人	积极
独立女性人设是08年某女作家开始出书，之后各个综艺，平台，yzh，开始大谈独立女性人设，曾经的papi是个代表，可惜她结婚后被女拳骂了几年，所以国家可没有支持独立女性或者独立男性。望周知	积极
唉，女性社会地位啊～真是一言难尽！不知道啥时候能真正的解决这问题呢？ 石家庄	积极
类似的事件已经不是一次两次了，为什么这样的事情会一而再再而三地发生，值得深思。我觉得这种事情恐怕还有很多很多，报道出来并上了热搜的只是极个别而已。具体到事件本身，怀孕被劝退，员工有员工的委屈，老板有老板的苦衷。首先，我们当然要谴责这家公司没有人性，而且，还不仅仅是没有人性，是已经违法了，怀孕员工可以通过法律手段维权。其次，我们也要具体问题具体分析，公司请员工干活不是做慈善事业的，是要给公司创造价值和利润的，特别是在一些民营企业，大多是一个萝卜一个坑，如果员工因为怀孕的原因导致无法给公司创造价值和利润，甚至反而要贴钱，恐怕每一家公司都会因此掂量掂量用工成本问题，今后，恐怕女性找工作的难度也会越来越大了。	积极
"	消极
本来还是热搜第一，嗖的一下就从榜上不见了～"	消极
女性请产假的痛点，怎么破？一方面是女性怀孕请产假的正常权益被压榨，一方面是一些人借规则漏洞刚上岗不久请产假增加公司负担，但是前者是更应该被重视的情况，后者毕竟是少数。不过，后者的行为又会增加社会对女性的“偏见”，这两个问题其实是有影响的。你觉得该如何解决？	积极
"	消极
	消极
女子怀孕七个月被公司称没产假劝退	消极
	消极
这个其实不用求助媒体啊，直接申请劳动仲裁肯定全胜啊。 云中漫步_原创诗画的微博视频"	积极
"	消极
笑死 就这还tm鼓励生三胎？"	消极
"	消极
这就是为什么很多职场女性不敢生孩子的原因！	消极
这就是为什么有那么多大龄女性不婚不育的原因！	消极
这就是为什么男女平等很难实现的原因！	中性
这就是为什么最近女权主义很火的原因！	消极
	消极
男女出生开始生理上就不平等了！！！	消极
如果还有很多这样的公司存在，那么社会问题确实是很难解决！"	积极
看到这种新闻我就生气，老板太缺德了	消极
"	消极
看来今后为保住工作，女性只能在入职前摘掉子宫以明志向了"	积极
我靠？请问这是在干什么？	消极
" 所以虽然国家已经开放了三孩政策，甚至有些地区已经实施补贴，可为什么老百姓还是不敢生呢？	消极
除了现在养育孩子的成本太高，另一个因素就是，此类“女性怀孕后，被单位变相辞退的风险”。	消极
要知道，现在大部分家庭都是双职工家庭，而且社会主要生育力人群8090后，他们这一批恰恰又是计划生育那一批，所以压力真的山大啊！	积极
对于用人单位，就男性到了35岁以后，都会面临职业危机，对女性生育就更不友好了。	积极
所以想要落实三孩政策，政府除了拿出相应物质上的补贴，还需要切实抓好职业就业这方面的软性补贴。"	积极
就这 还生三胎呢女性工作上受到的歧视还少吗？	消极
国家天天催生二胎，生三胎，各行各业潜规则不招二胎妈妈，生两个都被职场严重歧视……	消极
"	消极
这样吧，又想要孩子又想让女性干活，那建议专家研究男性生殖 我觉得这个建议很中肯咧，满足专家要求呢"	积极
"	消极
这还生个屁啊 一胎 二胎 三胎都不想生"	消极
已婚未育找工作都难。开始就被拒之门外了。更别说在职期间怀孕了。交五险的公司根本面试都过不了。反正你说什么人家都不会信。	消极
就这还生孩子，生个球，一个都不生，没有孩子就不会影响他们了，也不会被无理辞退	消极
"	消极
就这还想要女的尽义务为国家增后代	积极
吃shi去吧"	消极
"	消极
每天一个恐婚恐育小技巧"	消极
"	消极
整个采访流程，暴露了土鳖公司一般操作：	消极
找工作人员（不清楚）→找经理（开始编借口）→闹大了（调解改口）。	消极
不管是不是外编，怀孕员工在为你工作，就该保证她的权益。支持所有遇到问题的孕妇维权，法律是最佳武器！"	积极
老板没妈系列	消极
真希望男的能自己生孩子	积极
在当今职场如此歧视孕妇的情况下，还想妇女生三胎，zf实在想太多	消极
其实我觉得三胎落实前 这种劝退三期妇女的东西先落实了 再去说三胎 事业单位编外人员也是 没有产假什么的 反正你生娃就辞退就是啦 这还三胎呢 自己能活着就不错了 物质基础不做好 上层建筑就别指望 除非国家的真正意图是高知高收才是三台对象 那不好意思 是我打扰了	积极
"	消极
	消极
一边鼓励多生，一边鼓励独立女性，职场女性，好家伙，感情女人是超人呗！要结婚，要生娃，要防小三，要经济独立，要处理好婆媳关系，要照顾好家庭，工作还不能出错！ 哎，女人太难了要在这个社会生活下去也太难了！"	积极
"	消极
女职工保护的法规、劳动法、劳动合同法，可以了解下，法治时代，企业需尊重女员工的合法权益。"	积极
"	消极
热搜降挺快啊 刚不还在第一吗 在害怕什么"	消极
国家都强制性要求公司必须给女职工放产假，并且生育津贴如数返还给生育女职工，还有公司敢不响应国家政策？这是什么小作坊公司？	消极
"	消极
	消极
女性员工权益和公司的逐利性，永远存在矛盾。	积极
	消极
如何更好的协调好二者的矛盾，是个很大的话题好，需要很多方面来努力。	积极
	消极
不解决好，不只是女性权益得不到保障，生育率还会降低。"	积极
"	消极
	消极
okok 梦里已结扎 已绝育 子宫也已上锁🔒"	消极
我现在在备孕期我都不知道该不该找工作，也怕干了两个月怀孕了公司不要我或者我没法好好上班，真难啊	消极
呵呵就这样还鼓励生三胎，真当全国女的都是公务员事业单位啊	消极
"	消极
一想到女职工有可能会生三个孩子企业就不愿意招女的了	积极
	消极
女生好难"	消极
还鼓励三胎	中性
"	消极
	消极
看了一下这个案例，实在是叹为观止。员工怀孕，企业要辞退，理由是外编人员没有孕期说法。结果记者一来，领导们纷纷认怂。又说不知道她怀孕，又说怕累着员工了。听起来好心好意，但结论是解除劳动关系，你生完孩子再来上班。真是100%的又怂又坏。	积极
	消极
分享一点关于女性生育的劳动法规定：	中性
1）怀孕女员工拥有不被辞退的权利。	积极
一旦怀孕，不管试用期与否，公司几乎没有任何理由解雇你（第39条依然管用，但在实践中怀孕女员工只要不违法，公司强行说你违反公司规章解除合同几乎是必输的官司），直至三期（孕期、产期和哺乳期）结束。合同到期也得继续养着。	积极
	消极
当然企业可能会想用一笔违约金来劝退，我的建议是不答应，因为怀孕的你如果没工作会损失很多应有的收入（因为生育津贴和公司平均薪水挂钩，而失业妇女的月生育生活津贴，按市人力资源社会保障局规定的最低标准计发），而且哺乳期求职难度超级高，除非这笔钱高得离谱……	积极
	消极
2）工作内容不被改变的权利	积极
很多公司为了恶心女员工离职，会要求给女员工换岗。但事实上，企业无权单方面给员工换岗，换工作地点，降低基本工资。劳动合同法第三十五条规定：用人单位与劳动者协商一致，可以变更劳动合同约定的内容。变更劳动合同，应当采用书面形式。	积极
	消极
3）工作时长不被延长的权利	积极
不仅如此，怀孕期间不得延长劳动时间，一般不得安排其从事夜班劳动。不能胜任原劳动的，应予以减轻劳动量或者安排其他劳动。	积极
	消极
4）产检算工作时间	消极
2012年《女职工劳动保护特别规定》第六条第三款规定，怀孕女职工在劳动时间内进行产前检查，所需时间计入劳动时间。	积极
	消极
5）公司玩阴招，想气走我，怎么办？	消极
有些领导真让人头痛。咱也别气坏了身体，影响孩子就不好了，这样吧，去医院告诉医生你头痛（事实是头疼嘛）开一张长病假单（一个月应该要去补开一次），一直开到三期结束……	消极
	消极
这公司，我佩服的，要求员工先辞职生孩子，生完再入职。真的一点社会责任都不抗啊。在如今鼓励生育的大环境下，还有这种企业公然顶风违法，难道不应该重罚以示惩戒吗？	积极
	消极
这种事情不在少数。网上一搜，一大把「怀孕女员工被辞退」的新闻，如果没有重罚，企业没有违法成本，那相当于变相鼓励企业违法，企业很清楚清掉一个怀孕女员工就赚一个，赶不走也没有额外付出。	积极
	消极
期待这种企业遭遇社会主义铁拳出击	积极
	消极
#微博新知博主#"	中性
就这大环境还鼓励跑胎呢，国家是给出很多福利和规定，但老板不愿意啊，企业不愿意啊，上有政策下有对策啊！	积极
就这大环境还鼓励跑胎呢，国家是给出很多福利和规定，但老板不愿意啊，企业不愿意啊，上有政策下有对策啊！	积极
"	消极
一边鼓励多生	消极
一边鼓励独立女性	积极
一边怀孕了就要被辞退	中性
真的就……？？？？？？"	中性
这种大环境下还生啥三胎啊	消极
"挺有意思的就是说	中性
#东北限电# |  "	消极
"	消极
挺好笑的，天天讲要尊重母亲可是你不先尊重女性	积极
她先是她自己，然后才是母亲"	消极
女职工不易，公司也很难，如之奈何？	消极
" 外编人员没有产假。这个回答好犀利。	消极
一个好的企业和公司，最好的方式是善待你的员工，才会有最好的回报。	积极
你对员工如家人，员工当你如父母。	积极
老板成天小九九苛刻自己的员工，你得到的回报一定是报应。	中性
	消极
请问一下公司的老板：您这是从哪里来的？"	消极
如果保姆怀孕被辞退了怎么办？这家就把保姆辞了啊！ 影视剧爆姐的微博视频	积极
"	消极
就问，你敢生孩子吗？	消极
一生孩子就失业，等到出月子，就感觉和社会脱节了。"	积极
教给你如何维权？ 瞬间笑尿裤了的微博视频	消极
这些问题也不是存在一两天了，为什么就不解决呢	消极
看看女性社会生存情况吧，还鼓励生呢，睁着眼装瞎子呢！又想利用女性子宫，又不给任何补偿。面上一套，暗里一套！你干脆出个规定：不生二胎一律死刑。	积极
国家天天催着生孩子，现实总是令人寒心 上海	消极
"	消极
企业就这么响应国家政策？还希望让女性生三胎，又想马儿跑，又不给马吃草。这样的案例后面越多，我觉得国家的三胎政策可以直接宣布退出了。"	积极
"	消极
嚯 今天继续恐婚恐育"	消极
"	消极
男女平等"	积极
傻屌	消极
"	消极
无论产前产后，受歧视的永远是女人。虽然说提倡三胎了，但现在这职场，这政策环境，哪个敢生啊"	消极
政策号召三胎，企业响应政策，哦原来是想让女性在家闷头生孩子啊！最好再回到什么无才便是德的时代	积极
谢谢，更加坚定了不婚不育的念头[开学季][开学季][开学季]	积极
还想让生三胎 生你🐎	消极
"	消极
部门全体加薪，唯独少了我这个孕妇！"	中性
"	消极
一边要女性生孩子，一边相关的保障措施也没到位，找工作的时候又对女性带有歧视，在家里既要女性挣钱,又要女性带孩子，能帮女人分担的丈夫很少，就这样谁会想生孩子，生孩子很有可能就会辞退，要不事业停滞不前。"	消极
即使公司对待孕妇很照顾，孕期女性也挺难的。比如我这个月吐得人模鬼样，抽血就抽了6次了一个月就得请6次假，能上午解决的尽量下午回去上班。但还是感觉自己很被动。【有时候在想，不知道未来是否会有这样的公司，不管生不生孩子，满2年工龄不论男女，都可以每周1天14-17:30上班的日子。每年就可以有50天。如果一直没使用，就可以用于孕期。】#孕期日记#	积极
这什么公司啊不批产假干脆全招男员工算了	消极
看看后续吧	消极
前几天刚看见一个博主的投稿，说已婚未孕，找工作被拒的特别惨，甚至都收到offer了，还是被通知不要她了 北京·北京大兴国际机场	积极
"	消极
	消极
谢谢，子宫已上锁"	积极
可能这方面法律还是不够完善， 不够严格处罚，经常看到类似热搜，国家还提倡三胎，谁还敢生	积极
就这还鼓励要三胎呢？！	消极
"	消极
讲实话，在工作方面，对女性真的不公平。	积极
之前在做人事这方面工作的时候，很多公司提出的招聘需求有:	积极
1.打算近两年结婚/怀孕的女性不要。	消极
2.已婚女士不要。	消极
3.生了孩子的不要，一孕傻三年。	消极
4.女性不要。	消极
5.35岁以上的女性不要。	消极
6.有对象的女性不要。	消极
……	消极
哎，当女的真难，父母希望你早点成家有娃，丈夫希望你跟他一起奋斗养家，孩子希望你能多陪伴，国家希望你成为独立女性，公婆希望你照顾家庭。	积极
	消极
不说了，抠糖赚钱了。"	消极
资本家跟没妈一样，这句话绝了说的好，赶紧出书	消极
"	消极
专家:假的，女人们赶快去生三胎。"	消极
"	消极
又要人生又制造各种各样的困难，光是口头鼓励生有什么用..."	中性
"	消极
真希望有一天、男女怀孕几率各占50%	积极
这样世界可能会更美好一点，，起码qj案会少很多，"	积极
额，中秋节回去都被催二胎，看到新闻瑟瑟发抖	积极
现在想想我还是很幸福的 产假218天 每个月5000多的基本工资 虽然没有奖金和嘉奖了 生完孩子生育津贴就到账了 公司还是很大气的	积极
这什么公司啊	消极
"	消极
懂了这就不婚不育"	消极
"# 女子怀孕七个月被公司称没产假劝退 #	消极
既然开放三胎，就麻烦尊重一下。孕妇工作该获得的权益，一样不能少好吧"	积极
"	消极
“真是太恶心了，那些开公司的人是没妈吗？石头里蹦出来的？？这样针对欺负女性真够恶的。	消极
需要你的时候当牛做马，不需要直接把人赶走。太TM资本了，利益大于一切的吸人虫！”"	积极
谁鼓励生育，谁付钱。不从根本解决问题。不行的。总不能永远都是女性受苦吧？企业也很难呀。白白付一年左右的钱，这个钱应该谁主张谁付款	积极
我们公司合同明文写着，不得辞退哺乳期或者在职期间怀孕的女同事 郑州	积极
没有什么具体的鼓励措施，不要来催生了，还三胎！	消极
"	消极
放开政策的同时也请维护好女性该有的权益吧。"	积极
"	消极
从面试就会被问，有对象么？结婚了吗，什么时候准备生娃，有娃了吗，几岁了，家里有人带吗？	积极
是不是秒懂了，女人就的是“千面娇娃”	消极
一面光彩照人出得厅堂，一面生娃带娃入得厨房，还得在职场独立勇猛独当“一面”，更多面等待你发掘"	积极
国家建议生 那就多补贴，补贴个人补贴公司，光补贴个人了公司又不满意。。真难	消极
"	消极
讲个女同事的故事，不涉及隐私，都是大家日常知晓的：	消极
同事A应聘我们公司的探店主播，负责出镜美食类抖音视频，入职没多久宣布结婚，捞走了大家的红包（在办公室各种含沙射影说抠门的人才不给红包，于是大家都包了红包，但是她不尊重我们到连伴手礼都是缺斤少两），之后又立马怀孕，以怀孕不能吃油和辣为理由拒绝拍摄，于是换了文职工作给她，大家陪着她进行工作调整，自愿承担了她的part，并给她安排了文职中最轻松的工作，她却认为工作量增大，要求涨工资。文职期间她经常吃垃圾食品，比起探店吃的美食只会更差，前期还外出兼职摆地摊，后来被查出胎不稳，跟公司请了免费的假（老板出于人道没有扣工资），放假期间被发现在外面放风筝…中间各种弯弯绕绕也不多提，总结来说就是公司的人因为她调整了很多次工作，也因她嚼舌根闹过多次不愉快。但出于她是孕妈妈需要大家关怀，不能起争执生气影响宝宝，就算心里很不满，也都没有说过什么，都默默忍受了。前阵子她早产，提前休了产假。而如今孩子还在保温箱里，她却要求把产假拆分开来，先回来上班，等孩子出了保温箱再回去继续休产假，并且和老板说，来上班后要经常请假，没办法一天都工作。这意味着大家的工作将会再次被打乱，且是打乱起码两次。	积极
我们公司规模很小，她以获取生育补贴为目的来工作（亲口说的），却没有尽到自己的职责，照道理是应该开除的，但说实话，她几乎没给老板开除她的机会。公司里几乎都是女生，前期大家对于她，都是同情的，到现在，却个个对她避之不及。	积极
	消极
妈妈是世界上顶顶厉害的超人了。	消极
	消极
可是我真的不想让这样的人，来毁了“妈妈”的名声。"	积极
"	消极
外编人员没产假？这还自制法律啊？	消极
	消极
休产假，是女性劳动者的基本权利，不但不能辞退，还要予以照顾。	积极
	消极
依据《女职工劳动保护特别规定》，女职工在孕期不能适应原劳动的，用人单位应当根据医疗机构的证明，予以减轻劳动量或者安排其他能够适应的劳动。怀孕女职工在劳动时间内进行产前检查，所需时间是计入劳动时间的。这一点，恐怕很多公司都会忽视掉吧！	积极
	消极
另外，对于像许女士这样，怀孕7个月以上的女职工，用人单位不得延长劳动时间或者安排夜班劳动，并应当在劳动时间内安排一定的休息时间。如果违反，应当由县级以上人民政府人力资源社会保障行政部门责令限期改正，按照受侵害女职工每人1000元以上5000元以下的标准计算，处以罚款。	积极
	消极
现在公司承诺了，许女士可以正常回来上班。我是真心希望，公司可以给人家正常的待遇，孕妇本来身体就要格外注意，公司还给人家气受，换谁能受得了。"	积极
女性在职场本来就难 更何况是怀孕的女性	消极
【消除职业性别歧视，为女性就业权益转发！】#法姐讲法# 不知在您身边有没有这样的现象出现？未婚女性不招、生育一孩女性不招…职场性别歧视屡见不鲜。保障妇女平等就业权利，消除就业性别歧视。女性为社会做的付出，不该换来机会的不均。更多女性就业权益↓↓#今日说法# 民法典也有相关法条。@四川监狱 @曲靖检察 via→人民日报	积极
"	消极
	消极
看到有人说，一边鼓励女性生三孩，一边又辞退怀孕女员工，职场女性太难。	消极
	消极
其实，这完全是两码事：鼓励生育的是国家，辞退怀孕女员工的是企业。不是企业跟国家唱反调，而是企业的利益没有得到保障，资本又是逐利的，他们肯定会选择牺牲劳动者的利益，来保障自身的利益。	积极
	消极
这也是这次国家放开三孩政策时，提到要完善一系列配套制度的原因。要女性多生孩子，那就需要保护她们的合法权益，尤其在职场中，劳动法如何贯彻，相关社会保险如何落实，不只是国家一句“休假”“放假就可以了的，而要综合考虑保障女职工生育保险和保障的同时，平衡企业等相关方利益，才能让这孩子生得安心。	积极
	消极
#V光计划#"	中性
生孩子子？抱歉这就是现实	消极
郑州的职场常态各种不合规，不合法。	消极
过于强调公司对保护女性权利的义务，实际上受害者还是女性，因为公司在招聘时会有所考虑。假设女性怀孕产假期间公司的支出，能以减税等形式，减轻企业的负担，让企业真正的能一视同仁，才最符合女性的职场利益	积极
"	消极
	消极
又想要生育率，又不给实际的优惠政策！只能说现实很残酷"	积极
" 真是奇了怪了。	消极
我们公司助理怀孕，都是各种想方设法地给她提供方便，从备孕开始就知道，还生怕她工作压力太大。	消极
总有些公司不干人事。	消极
女性怀孕这个过程非常艰难，不帮就算了，还倒打一耙，你们没妈吗？"	消极
不得不说很多公司都存在这样的现场，对女性真的很不公平	中性
"	消极
一天天说什么三胎政策 其他硬件根本没跟上结局最后还是女性买单 承担后果。	消极
国家还给给那些婆婆 七大姑八大姨催生保驾护航而且你告诉公司说你不生孩子 公司敢信吗？你就直接发文 女的全部回家生孩子 不就好了"	积极
【九图了解休假那些事儿】关于休假的事儿，知识点要提前知晓！你的年休假有几天？没休的年假如何补偿？还有婚假、产假、探亲假....人在职场，这些假期关乎自身权益，你一定要知道↓↓转发，收藏！#调休人低效上班的一天# （人民日报）	积极
" 真是奇了怪了。	消极
我们公司助理怀孕，都是各种想方设法地给她提供方便，从备孕开始就知道，还生怕她工作压力太大。	消极
总有些公司不干人事。	消极
女性怀孕这个过程非常艰难，不帮就算了，还倒打一耙，你们没妈吗？"	消极
不得不说很多公司都存在这样的现场，对女性真的很不公平	中性
【九图了解休假那些事儿】关于休假的事儿，知识点要提前知晓！你的年休假有几天？没休的年假如何补偿？还有婚假、产假、探亲假....人在职场，这些假期关乎自身权益，你一定要知道↓↓转发，收藏！#调休人低效上班的一天# （人民日报）	积极
"	消极
一边国家提倡多生，一边怀孕公司就辞退你！相关部门应该多严查，投诉及时受理，维护女性职场权益！"	积极
是不是该提高开公司的门槛？？？	积极
"	消极
所以别再研究为什么年轻人没有结婚意愿生育意愿，这还需要研究吗长眼睛不会看🙂"	积极
什么破公司	消极
一方面要鼓励女子生孩子，养孩子，为国家做贡献，另一方面公司希望员工天天加班不要回家，很多女性高管都不敢生孩子。今天一位字节的女总监还告诉我她每天1点睡觉5点半去公司，根本没时间生孩子。这就是残酷的现状。如何平衡工作与生活？如何保障女性职工的职业生涯？我建议是否公司可以采用灵活用工的方式，让怀孕和有孩子的女性可以每周有几天在家上班或是错峰上班？办法总比困难多，你们还有什么好办法？	积极
"现实就是如此，举一反三的看。大家注意了么，这位女性是劳务派遣关系，批产假是挂靠公司的事，为什么是第三方公司，答案自在人心。其次，这还远远不到鼓励三胎的事，其本质和996一样，是违反劳动法的事，这是打工人的基本权益。这正常么，不正常，但抱歉，这却很普遍。	积极
	消极
怀孕不能休产假，批了也是不足额。产假期间不断的工作电话，停工不停产的居家办公。产后立刻复岗，没休完就天天软硬兼施的催。更别提休完产假回来，工作没了、岗位没了、职级没了、奖金没了，等等类似的情况。这普遍么，或许不普遍，但真实存在。	积极
	消极
你可以硬刚，且不提付出多少时间精力，也不说你赢的了多少，就单是被排挤被边缘就很难受，更别提35岁以上下岗再就业的困难。为什么如此，企业违F成本太低，员工维Q道路太难，要真是罚的狠，算算账就知道这不划算了。挣那么多钱，做个人吧，次顶配一样开。 #v光新星#"	消极
" 一边鼓励妇女多生，一边压榨劝退怀孕女性	消极
笑死	消极
保障不到位谁给你生	消极
自己生吧你"	消极
"	消极
女子因为怀孕被公司两次劝退，以公司的“编外人员”没有产假为理由，劝退已怀孕七个月的女员工，这就是典型的找理由劝退已经怀孕的员工啊！	中性
	消极
只要是签订了劳动合同，就有依法享有女性的权益，包括产假和各种假期，什么编外人员没有产假，这就是找理由劝退，这种做法涉嫌违反了劳动法。	消极
	消极
这件事，上了新闻，经过调解后，最后结果有了转变，公司懂得了尊重女性，知道保护孕妇的合法权益。	积极
	消极
我觉得，得更应该好好反省反省吧自己此前的操作方式！"	积极
"	消极
女性工作者在怀孕🤰中遇到不公平对待，已经不是个例，不予关怀和支持的企业无非只是考虑自身经营效益，缺乏对女性员工的正常看待，当然从法律角度已经可以起告。国家在鼓励倡导生育的口号，真的希望能从各个方面观察讨论，尤其是如何帮助女性工作者回归职场等等此类问题。我有个不成熟的小建议：企业经营要考虑自身问题，招聘女员工是不可避免的，如果可以通过企业内有生育的女性员工产后提供社保缴纳证明，产检资料，出生证明等，企业可以享受相应的税务政策，也许企业对招收女员工或者对怀孕女员工能多一些包容，支持。只是个人想法，也可以开通产后女性（产假期间身体时间可以的情况下）线上办公（企业十分必要的话，处理主要问题），都是可以尝试的。这样回归后能更快进入工作，职位也能得到保留……这些都可以多讨论。国情如此，虽然不像一些国家生的多实实在在得到国家帮助人民没有生养教育负担，按照我们的情况也可以多多讨论，希望未来有更多好的改变吧"	积极
"	消极
这谁还敢生啊？？我看老板也挺没用的"	消极
倒不如说女性更像是“牲口”——要能干也能生。既得利益者们从来不会考虑你到底是不是个独立意义上的“人”，资本家们也只会大嘴一张，大手一挥“积极响应”，女性的“死活”并没有多少人操心。	积极
之前有个女同事来公司三年生了两娃，一年时间在休产假，工资全额发。老板也算仁慈，我是老板我可不乐意。需要相关部门提出合理的解决方案。	积极
谁敢生孩子 生孩子就失业，房贷车贷养孩子 都是钱。开放三胎 ，现在一胎都不敢生	消极
"	消极
现在有些公司的钱感觉不是挣出来的而是从员工身上省出来的	中性
五险一金要么干脆不交，要么交也不足额交	消极
公司福利也是，要么一开始就没有，非要一边说自己福利多么多么好，一边又各种抠搜	中性
一边不把员工当人看，一边又是啥公司凝聚力。	积极
赶紧滚呐"	消极
"  生育对于女性的代价，不仅仅是肉体上的痛苦，她们的事业和未来也被摆在了最岌岌可危的地带。	消极
	消极
我们曾和几位全职带娃后重返职场的女性聊了聊，她们比普通人更为谨慎而坚硬地拼搏着。	积极
	消极
职场普遍盛行的歧视，让她们普遍失去了更好的工作机会和收入；	积极
	消极
传统思想中对于女性顾家的要求，加剧了职场女性们兼顾事业和家庭的艰辛；	积极
	消极
而想要证明自己、担心拖累他人的压力，成为了焦虑的源泉。"	消极
【#因怀孕开除员工合法吗#？】根据妇女权益保障法第二十七条，任何单位不得因结婚、怀孕、产假、哺乳等情形，降低女职工的工资，辞退女职工，单方解除劳动（聘用）合同或者服务协议。但是，女职工要求终止劳动（聘用）合同或者服务协议的除外。此外，劳动法第二十九条也有规定，女职工在孕期、产期、哺乳期内的，如没有发生严重违纪、失职或者被依法追究刑事责任等情况，用人单位不得解除劳动合同。女职工在孕期、产期、哺乳期内被单位违法解除劳动合同，可要求单位继续履行合同，并可主张用人单位赔偿劳动合同解除日至劳动关系恢复之日期间的工资损失。如果不要求继续履行合同，则用人单位应当按照经济补偿的两倍支付赔偿金。（来源：法治日报）#普法课堂#	消极
这就是中国特色，在欧美，这样的企业估计早被告得倒闭了。 成都·高新区	积极
估计，国家提倡三胎，是让有能力的人生，不是让人人都生。	积极
"	消极
怀孕产检需要人陪同	积极
生孩子坐月子需要人陪同	中性
孩子成长需要父母陪同	积极
	消极
公司男女产假、产检假同等才能解决职场歧视"	消极
" 这公司的人力是头铁加法盲，三期（孕期、产期、哺乳期）女性员工劳动权益受法律保护，员工掌握主动权。如果要辞退可以协商赔偿，按规定支付赔偿金，女员工也接受的话，可以拿钱走人。如果女员工不想拿赔偿，要求继续履行劳动合同，企业就不能辞退，给赔偿也不行。	积极
	消极
视频里这位真是算盘打的精，怀孕，生产，哺乳期就让离职，等都安顿好了想来再来，企业倒是一点损失没有，但是女员工的合法权益被侵占了。	积极
	消极
没啥好说的，申请劳动仲裁完事。#微博新知博主#"	中性
"	消极
还开放三胎呢 我笑了 希望国家加大力度严惩这种企业 国家不管这些事情	积极
正如996的“福报” ：愿意生孩子的年轻人越来越少"	积极
谁生三胎？	消极
生三胎	消极
一告一个准吧	消极
在公司的角度上，就是又发工资又没人干活，谁愿意呢，所以还是男人好，没毛病	积极
"	消极
	消极
本来社会对女性就很多歧视了，现在又要提倡三胎，女性还需要有自己的向往吗？怎么让女性独立呢？男性还很难接受全职太太，你让女生怎么活？多重影分身之术……	积极
	消极
你们还想找男朋友结婚生子吗？"	中性
又要女性经济独立，人格独立，又要生孩子，生二胎，又要妈妈是超人，又要母乳喂养，又要当个好媳妇好妈妈好老婆。一个女人，人生太难。女人人生的意义是什么？燃烧自己，奉献自己吗？	积极
"	消极
就这还三胎？"	消极
凭啥让孕妇上班？怀孕不就等于全时段无休上班吗？？？？这不是一个人干俩活吗？——又凭啥不让孕妇上班，凭啥剥夺孕妇工作权利？女人争点气，拒绝生育，倒逼人造子宫问世普及！否则就只能卡在这个境地无解！	消极
"	消极
呵呵，试问谁找工作的时候没经历过呢"	消极
又想要生育率，又不给实际的优惠政策，也别怪女人不想生孩子了，企业都不敢招女性了，太卷了，太操蛋了，太魔幻了	中性
就这？还三胎？搞笑作为女性看到这样的新闻真的会很焦虑，就这样吧，不婚不育保平安[开学季]	积极
所以好多公司招聘25—45岁的，就以为她在25岁之前完成了结婚生育，呵呵	积极
以后大家都别生了不敢生	消极
"	消极
还三胎呢nm"	消极
体制内对女性生育是最友好的，很多私企都会暗示最好离职！	积极
这真不好评说，你说老板难，马上会有攻击，你说某些现象那么你就也会被攻击，还是努力工作，只要你努力工作，在公司举足轻重，老板给你一年产假也会留你！就说这些吧	消极
体制内对女性生育是最友好的，很多私企都会暗示最好离职！	积极
这真不好评说，你说老板难，马上会有攻击，你说某些现象那么你就也会被攻击，还是努力工作，只要你努力工作，在公司举足轻重，老板给你一年产假也会留你！就说这些吧	消极
对这样的公司一定要进行严厉的处罚，让他们明显得不偿失！这种行为不仅是违反了相关的劳动法规，而且是一种极其缺德的行为，与国家的大政方针更是不相符。而且女职工生育期间的工资很多是走社会保险，实际上公司负担不了多少钱。还这样对待怀孕女工，太不应该！	积极
一方面国家提出放开三胎政策，另一方面某些公司变相阻止女员工生育，自己打自己的脸，是政策的不到位，还是政策规范上有问题，作为一个女性生育真的很难 六安	中性
这个公司法人是法盲吧	消极
就说一句，结婚生子让女人没有安全感，本来社会上生存的女性就担惊受怕的，结婚生子不仅丢掉铁饭碗，人身安全还没有保障了，谁结婚啊？	积极
刚豆瓣还看到一个去面试被hr说97年年龄太大 它们公司都是00后的	积极
要想女性不被职场歧视，应该给男性也放产假，男性的产假又其配偶享受，男性所在公司要共同担负男员工配偶产假期间的产假工资，这样的话实在觉得亏的公司就不要招人了，毕竟大多数人会结婚生子，生了一胎还会有二胎、三胎、并且男的也需要报销产假工资，这样不会不会好一些呢？？？	积极
这样的情况下谁敢生孩子，难道就靠一句我养你吗	消极
还能这样的啊？！有签劳动合同吗？既然鼓励生育，对于职场女性的相关补贴、假期等都要落实才行啊。	积极
还能这样的啊？！有签劳动合同吗？既然鼓励生育，对于职场女性的相关补贴、假期等都要落实才行啊。	积极
双休都没办法普及，社保都没办法普及	消极
"	消极
蛤？为什么没产假呀？还要被劝退？	消极
不明白"	中性
"	消极
谁生孩子谁有病"	消极
好恶心这个操作，男的要是也能怀孕，看这些人还会不会这样过分	中性
就这还天天催生呢，傻子才生	消极
我离找女朋友，成家的愿望又远了一步……	积极
"	消极
哎哟哟这以后谁还敢生孩子"	消极
"	消极
	消极
国家提倡二胎，医院提倡母乳，专家不建议隔代带娃	积极
婚姻法要求女性经济独立，宝宝需要妈妈时刻陪伴	积极
老公要求老婆貌美如花，婆婆要求儿媳孝顺顾家有事业	积极
这样的社会压力谁还敢生 济南·鲁商盛景家园"	消极
呵呵 咱们就是说 男的又靠着女的生娃 然后又不爱聘用女生 呵呵呵呵呵	消极
女性因为怀孕丢了工作，到头来压力就转到了男方身上，苦的永远是老百姓而已还三胎呢我笑了	积极
哈哈哈哈对不起，专家这次怎么说？？？	中性
严重违反劳动法，无良企业，格局太小注定做不大	消极
" 以没产假为由辞退怀孕员工违法！不论正式员工，还是临时员工，不论编内员工，还是编外员工，只要签订了劳动合同，都有权益依法享有产假！如果公司规定员工没有产假，就已经违法了劳动法！	积极
	消极
建议查查这家公司，明目张胆跟劳动法对着干，无视劳动者权益。现如今很多公司都不遵守劳动法，建议查查这些公司，杀鸡儆猴！#微博新知博主#"	积极
"	消极
生孩子真的是个大问题，一个就够麻烦的了，现在还提倡三个"	消极
"	消极
我产假结束了，合同也到期了，提了离职，最后两个月的工资没给我发，无处维权"	消极
就这样，好想让女人生三胎。	消极
" 别提了哦，就我之前上班那个医院，我提了离职招来了新人。	积极
一个93还是91年的小姐姐，人家从外地回来，就是闯荡回来了准备安定下来，跟男朋友结婚的。	积极
结果没上几天班就要离职了，原因是护理部跟人家要求说两年之内不能怀孕。	积极
无语子"	消极
这就是生育率下降的原因 之一	消极
"	消极
国家提倡三胎，企业劝退孕妇，电视剧宣传女性经济独立，做女人真难！	积极
幸好，公司最终和员工达成和解，表示要尊重女性和遵守劳动法，算是保护了孕妇的权益。	积极
虽然有立法保护，但实践中一些企业确实不愿意用女工，不愿意用孕妇，这是事实。	积极
如何切实鼓励和保障孕妇的合法权益？需要政府下大力气进行普法宣传和有效监督，并加大力度惩治侵犯女工的违法行为，以确保每个生育女性得到应有尊重和合法保护。#微博公开课#"	积极
这种言论怎么能从一个女性嘴里说出来	消极
"	消极
挺无语的这公司一点也不人性化"	中性
对女性的双标日常罢了🙅	中性
"	消极
这时候不得不拿出我压箱底的图"	消极
"	消极
	消极
女子怀三胎请假后，却以旷工为由要被开除？ 你这种状况持续多久了的微博视频"	消极
"	消极
三胎政策，产假一年。将来你我会仅仅是一个家庭的生育带娃工具人吗？"	消极
"	消极
我以前公司调怀孕5个月的同事去外勤部跑销售……"	积极
我同事怀孕七个月把自己当祖宗好吃懒做…七个月不干活，现在大家都忙叫她干点活还发牢骚，说单位人都死光了要她一个孕妇做事	消极
相关部门一定要出来管管，要不然开放几胎政策都一样。孕妇失业不仅仅是没有工作那么简单，背后社保断缴，无法领取生育津贴，无法报销住院费用等等，一系列后果真的不是普通家庭能承受的。当时我怀孕后犹豫了很久很久要不要放弃工作，但是为了能减小经济压力我坚持到了现在，马上休产检了，公司也没有说太多	积极
" 所以，还呼吁结婚呼吁生子，呼吁二胎三胎	消极
呵呵，生完孩子家里蹲了，拿什么养孩子？为母则刚也不至于说女性生完孩子就该啥工作也不挑，有活干就行，一切为了养孩子吧？"	消极
" 所以，还呼吁结婚呼吁生子，呼吁二胎三胎	消极
呵呵，生完孩子家里蹲了，拿什么养孩子？为母则刚也不至于说女性生完孩子就该啥工作也不挑，有活干就行，一切为了养孩子吧？"	消极
我们单位各种人性化，怀孕的员工各种少做事，怕你累着了怕你辛苦了，即使你才怀孕一两个月，已经怕你请产假不好交接工作了，全部分给没怀孕的同事，然后没怀孕的同事就惨了	消极
"	消极
真别再让生了"	消极
"	消极
	消极
这才是真实的社会啊，什么三胎政策全是废话！希望能严肃处理"	积极
又勾起了2019年被郑州某养老公司孕期被辞退的回忆，岗位财务，工作轻松，老板还是觉得我的身体不适合工作。可是我向来身体健康，没耽误过一天工作啊	积极
"	消极
	消极
这个社会对女性就是如此不友好，很多女性到了孕期就会面临失业的危机，说着男女平等，其实在很多方面女性还是吃亏的！！！"	积极
"	消极
	消极
国家政策鼓励生育 公司却这样对待孕妇	积极
公司你说你做的对吗	中性
这样下去 这家公司还有未孕女职员去吗"	中性
就这还想让我们生三胎??	消极
MD郑州咋老是出这种阴间新闻	消极
"	消极
所以女性不要生孩子，会被歧视的"	消极
就这还让生三胎	消极
"	消极
	消极
每天一个恐婚恐育小新闻！	消极
就这还天天催生，真的很难让人支持政策"	消极
怎么这种事情这么多，记得前几天也有个这种热搜	消极
"女人真挺难的。很多男人觉得结婚就是理所应当的女人要照顾他，照顾他父母，照顾孩子，还要洗衣做饭，还要上班。	积极
	消极
然后女人在职场又被变相歧视对待。这是现实问题。整天让生生生，问题不解决几个真敢生那么多。以后老了，什么都领不到，还没有话语权。	消极
	消极
"	消极
哈哈哈 以后谁敢生孩子呀	积极
女生一旦结婚 更没有保障了。工作找不到，整个是免费保姆，太崩溃了	消极
"	消极
每次看到这样的新闻内心十分纠结的。	中性
因为这个矛盾点被弱化了，被魔改了，被媒体因为流量，侧重点在“孕妇”受到的待遇，而不是“企业”所作所为，企业在调解后，他觉得他应该尊重女性，还说这是社会和公司应该做的。	积极
他不尊重的只是女性吗？他不合理的方式对待的明明是一个劳工，是每一个编制外的人，只是这个人，在这时候，在这个新闻，她是个孕妇。	积极
	消极
多方努力保障了她的权利，全公司上下和社会流量都照顾这个孕妇，可是编外人员和临时工数以千万计，没得只是个产假吗？有的五险一金都不全，有的人也不多，绩效奖励和公司没关，福利什么想都别想，甚至这些人主要功能是用来顶替编制内的，有很多岗位甚至编制内的不工作都行，都是劳工外包，他们活照做，所有的一切都算是别人的，随时还会被开除。	积极
可他们都是普通人，他们不是孕妇啊怎么办？	中性
	消极
当遇到这个情况是个孕妇，企业就变得十恶不赦了，大家的重点，是孕妇受到不公待遇，而不是企业做出违法行为，不是孕妇的话，现实中到处都发生，谁管他死活累不累辛苦不辛苦，我自己还辛苦呢，有媒体给他们说话吗？	消极
因为给他们说话没有对立点，挑不起民众情绪，他们那就只能活该了，哪里像这个新闻里，是个女性受到不公待遇，刚好还是个孕妇，那不知道社会有多少闲在家的流量站起来帮他们打仗似的，反复艹流量，一遍遍的骂，虽然明天编制外的还是这个待遇不会变，但是她们今天先骂过瘾。	消极
	消极
像西安拖出地铁那个女的，要不是个女的，还刚好是那个年纪，才有这批人站出来这不公那不公的，她哪怕是个大妈都没人会给她发声，北京那大妈别说低素质扰乱公共治安了，、骂了人，真拖出去网上看了也只会拍手叫好，拘留也拍手称快，要是个男的拖出去搞这样，别人不但不会给他说话，甚至会觉得应该打一顿。重点都被各种流量带着早偏了，全都模糊成男女了，清一色的是“男的不能对女的这样”，而不是“管理人员不该对乘客这样”。	积极
这个企业也是，连他自己都反省偏了，全变成不该对孕妇这样，而不是企业不该对员工这样。"	中性
【职场孕妈，这些权利一定要了解！】在职场，孕妈受哪些法律保护？享有哪些权利？看图了解↓ （央视新闻）	积极
"	消极
每天一个恐婚恐生消息	消极
呵呵"	消极
"	消极
每天一个恐婚恐生消息	消极
呵呵"	消极
提供尽量多的公共服务和相配套的教育、就业、医疗等措施才能支撑起三胎政策，否则只有富人有底气去生三胎	积极
"	消极
专家不是说有产假吗	消极
公司为啥不履行…… 北京"	中性
女性才站起来几天，又要回去了	消极
所以别结婚，别生孩子，太恐怖了	消极
此时，很想知道网上沉默的男人们，都怎么想这个问题（因为我看见讨论的都几乎是女性）你们结了婚的，自己老婆如果面对这种情形，有没有想过怎么共同面对或者维护啥的？我真的很想知道男的想法。	积极
"	消极
哈开放三胎但有些女性连产假都没有 这不是逼着人放弃工作放弃社会关系 待在家里靠着丈夫赏赐的那点钱过日子，生孩子带孩子一辈子都被活活困在这个丈夫和孩子形成的“家”里吗？"	消极
"	消极
	消极
唉，非常现实的话题！	中性
女性需要尊重，孕妇在怀孕期间的权益必须得到保护！如果做不到谈何鼓励三胎呢？"	积极
"	消极
达咩🙅	消极
这谁敢生啊"	消极
笑了，这谁还敢结婚怀孕生孩子，工作丢了自己没有收入的话，老公人好还行，万一遇到渣老公，骂你吃他的住他的，这时候女人就有苦说不出了	消极
这种现象很多，比比皆是，我的情况也类似 临沂	消极
这事儿有点难办。编外就属于非正式员工，和临时工差不多。不过都怀孕七个月了，企业不可能不知道她是孕妇，关键时刻劝退和渣男无疑。假如该女子工作效率没有问题的话，公司应该酌情处理！	中性
我现在结婚了 想换个工作都怕他们不要我[苦涩][苦涩][苦涩] 怕面临这种问题	消极
【  广东休产假有新规！】#广东人这样休产假# 今年10月1日起正式施行的《广东省职工生育保险规定》明确，女职工生育多胞胎的，每多生育1个婴儿，增加15天。如果是怀孕未满4个月终止妊娠的，产假有15天至30天；怀孕4个月至7个月的，产假42天；怀孕满7个月终止妊娠的，产假计75天。与现行规定相比，终止妊娠的产假细分为不同情况，并延长了天数。 今日最新闻官方微博的微博视频	积极
之前有条新闻好像是说一个女职员连续三年生了三胎公司又给工资又交社保完事三胎产假休满就提了离职，公司感觉被白嫖了三年就上了1818黄金眼还是哪家媒体成了社会新闻，用人单位和未婚未育女性员工的关系无事发生的时候谁都不想生事，但一旦发生一点点矛盾就会变得不可调和，甚至像这样在社会新闻板块成为谈资，说实在的，当事双方都挺难的，但媒体就很开心	积极
每天一个恐婚恐育小新闻，可怕	消极
女人太难了，怀孕担心工作，不工作又说女人不独立！难难难 武汉	消极
公司:你都怀孕了 又不能给我干活 我为啥不劝退你？	积极
"	消极
环境如此不会真的有人要生孩子吧"	消极
